bacru	utter	atr	utter	
badna	banana	banan	banana	
badri	sad	sad	sad	
bajra	run	ran	run	
bakfu	bundle	pak	pack	
bakni	bovine	aks	ox	
bakri	chalk	cak	chalk	
baktu	bucket	baket	bucket	
balji	bulb	balb	bulb	
balni	balcony	balkani	balcony	
balre	blade	bleid	blade	
balvi	future	leitr	later	
bancu	beyond	biand	beyond	
bandu	defend	difend	defend	
banfi	amphibian	amfibian	amphibian	
bangu	language	languij	language	
banli	great	grand	grand	
banro	grow	gro	grow	
banxa	bank	bank	bank	
banzu	suffice	safaiz	suffice	
bapli	force	kampel	compell	
barda	big	larj	large	
bargu	arch	arc	arch	
bargu	arch	arm	arch	
barja	bar	bar	bar	
barna	mark	mark	mark	
bartu	out	aut	out	
basna	emphasize	aksent	accent	
basti	replace	sabstatiut	substitute	
batci	bite	bait	bite	
batke	button	batn	button	
bavmi	barley	barli	barley	
bebna	foolish	bub	boob	
bende	orchestra	band	band	
benji	send	send	send	
bersa	son	san	son	
berti	north	nort	north	
besna	brain	brein	brain	
betfu	abdomen	beli	belly	
betri	tragedy	trajik	tragic	
bevri	carry	ber	bear	
bidju	bead	bid	bead	
bifce	bee	bi	bee	
bikla	whip	lac	lash	
bilga	obliged	ablaij	oblige	
bilga	obliged	oblaij	oblige	
bilma	ill	il	ill	
bilni	military	milateri	military	
binra	insure	incr	insure	
binxo	become	bikam	become	
birje	beer	bir	beer	
birka	arm	arm	arm	
birti	certain	srtn	certain	
bisli	ice	ais	ice	
bitmu	wall	ual	wall	
blabi	white	uait	white	
blabi	white	xuait	white	
blaci	glass	glas	glass	
blanu	blue	blu	blue	
bliku	block	blak	block	
bloti	boat	bot	boat	
bolci	ball	bal	ball	
bongu	bone	bon	bone	
botpi	bottle	batl	bottle	
boxfo	sheet	foil	foil	
boxna	wave	ueiv	wave	
bradi	enemy	adverseri	adversary	
bratu	hail	xeil	hail	
bredi	ready	redi	ready	
bridi	predicate	predakit	predicate	
brife	breeze	briz	breeze	
briju	office	biuro	bureau	
bruna	brother	bradr	brother	
bukpu	cloth	klat	cloth	
bumru	fog	fag	fog	
bumru	fog	mist	mist	
bunda	pound	paund	pound	
bunre	brown	braun	brown	
burcu	brush	brac	brush	
burna	embarrassed	dimencn	embarrassed	
burna	embarrassed	imberast	embarrassed	
cabna	now	nau	now	
cabra	apparatus	aparatas	apparatus	
cacra	hour	aur	hour	
cadzu	walk	uak	walk	
cafne	often	afn	often	
cakla	chocolate	caklat	chocolate	
calku	shell	cel	shell	
canci	vanish	vanic	vanish	
cando	idle	aidl	idle	
cange	farm	agrer	agrar-	
canja	exchange	iksceinj	exchange	
canko	window	sindo	window	FIXIT correct transcription ``uindo''
canlu	space	valium	volume	
canpa	shovel	cavl	shovel	
canre	sand	sand	sand	
canti	gut	entreilz	entrails	
carce	cart	cariat	charriot	
carce	cart	kart	kart	
carmi	intense	brait	bright	
carna	turn	trn	turn	
cartu	chart	cart	chart	
carvi	rain	rein	rain	
casnu	discuss	diskas	discuss	
catke	shove	cav	shove	
catlu	look	luk	look	
catni	authority	atorati	authority	
catra	kill	slatr	slaughter	
caxno	shallow	calo	shallow	
cecla	launcher	lanc	launch	
cecmu	community	kamiuniti	community	
cedra	era	era	era	
cenba	vary	ceinj	change	
censa	holy	seikred	sacred	
censa	holy	xoli	holy	
cerda	heir	er	heir	
cerni	morning	mornin	morning	
certu	expert	eksprt	expert	
cevni	god	diviniti	divinity	
cfari	initiate	start	start	
cfika	fiction	fikcn	fiction	
cfila	flaw	fla	flaw	
cfine	wedge	uej	wedge	
cfipu	confuse	knfiuz	confuse	
ciblu	blood	blad	blood	
cicna	cyan	saian	cyan	
cidja	food	fid	feed	
cidni	knee	ni	knee	
cidro	hydrogen	xaidrojn	hydrogen	
cifnu	infant	infnt	infant	
cigla	gland	gland	gland	
cikna	awake	aueik	awake	
cikre	repair	fiks	fix	
ciksi	explain	iksplein	explain	
cilce	wild	uaild	wild	
cilmo	moist	moist	moist	
cilre	learn	lrn	learn	
cilta	thread	filamnt	filament	
cimde	dimension	dimencn	dimension	
cimni	infinite	infanit	infinite	
cinba	kiss	bas	buss	
cindu	oak	ok	oak	
cinfo	lion	lain	lion	
cinje	wrinkle	rinkl	wrinkle	
cinki	insect	insekt	insect	
cinla	thin	lin	lean	
cinla	thin	tin	thin	
cinmo	emotion	imo	emo-	
cinri	interesting	intrist	interest	
cinse	sexual	seks	sex	
cinta	paint	peint	paint	
cinza	tongs	tanz	tongs	
cipni	bird	brd	bird	
cipra	test	pruf	proof	
cirko	lose	luz	lose	
cirla	cheese	ciz	cheese	
ciska	write	skraib	sribe	
cisma	smile	smail	smile	
ciste	system	sistm	system	
citka	eat	it	eat	
citno	young	ian	young	
citri	history	xistri	history	
citsi	season	sizn	season	
civla	louse	laus	louse	
cizra	strange	bizar	bizarre	
ckabu	rubber	rabr	rubber	
ckafi	coffee	kafi	coffee	
ckaji	quality	kualati	quality	
ckana	bed	bed	bed	
ckape	peril	perl	peril	
ckasu	ridicule	skaf	scoff	
ckeji	ashamed	ceim	shame	
ckiku	key	ki	key	
ckilu	scale	skeil	scale	
ckini	related	kin	kin	
ckire	grateful	greitfl	grateful	
ckule	school	skul	school	
ckunu	conifer	kon	cone	
cladu	loud	laud	loud	
clani	long	lan	long	
claxu	without	lak	lack	
clika	mossy	laikn	lichen	
clira	early	rli	early	
clite	polite	palait	polite	
cliva	leave	liv	leave	
clupa	loop	lup	loop	
cmaci	mathematics	matamatiks	mathematics	
cmalu	small	smal	small	
cmana	mountain	mauntn	mountain	
cmene	name	neim	name	
cmila	laugh	laf	laugh	
cmima	member	membr	member	
cmoni	moan	mon	moan	
cnano	norm	norm	norm	
cnebo	neck	nek	neck	
cnemu	reward	riuord	reward	
cnici	orderly	nit	neat	
cnino	new	niu	new	
cnisa	lead	led	lead	
cnita	beneath	binit	beneath	
cokcu	soak	sokap	soak-up	
condi	deep	dip	deep	
cortu	pain	sor	sore	
cortu	pain	xrt	hurt	
cpacu	get	akuair	acquire	
cpana	upon	an	on	
cpare	climb	klaim	climb	
cpedu	request	ask	ask	
cpedu	request	rikuest	request	
cpina	pungent	piknt	piquant	
cradi	radio	reidio	radio	
crane	front	frant	front	
creka	shirt	crt	shirt	
crepu	harvest	rip	reap	
cribe	bear	ber	bear	
crida	fairy	feri	fairy	
crino	green	grin	green	
cripu	bridge	brij	bridge	
crisa	summer	samr	summer	
critu	autumn	atam	autumn	
ctaru	tide	taid	tide	
ctebi	lip	leibil	labial	
cteki	tax	taks	tax	
ctile	petroleum	oil	oil	
ctino	shadow	ceid	shade	
ctuca	teach	tic	teach	
cukla	round	srkl	circle	
cukta	book	buk	book	
culno	full	ful	full	
cumki	possible	meibi	maybe	
cumla	humble	xiumilati	humility	
cunmi	millet	milit	millet	
cunso	random	cans	chance	
cuntu	affair	afer	affair	
cupra	produce	produs	produce	
curmi	let	prmit	permit	
curnu	worm	uurm	worm	
curve	pure	piur	pure	
cusku	express	sei	say	
cutci	shoe	cu	shoe	
cutne	chest	cest	chest	
cuxna	choose	cuz	choose	
dacru	drawer	drar	drawer	
dacti	object	tin	thing	
dakfu	knife	naif	knife	
dakli	sack	sak	sack	
damba	fight	kambat	combat	
damri	drum	dram	drum	
dandu	hang	xan	hang	
danfu	answer	ansr	answer	
danlu	animal	anaml	animal	
danmo	smoke	smok	smoke	
danre	pressure	precr	pressure	
dansu	dance	dans	dance	
danti	projectile	balistik	ballistic	
daplu	island	ail	isle	
dapma	curse	dam	damn	
dargu	road	rod	road	
darlu	argue	argiu	argue	
darno	far	far	far	
darsi	audacity	adasati	audacity	
darxi	hit	xit	hit	
daski	pocket	pakit	pocket	
dasni	wear	uer	wear	
daspo	destroy	distroi	destroy	
dasri	ribbon	ribn	ribbon	
datka	duck	dak	duck	
datni	data	data	data	
degji	finger	dijit	digit	
dejni	owe	det	debt	
dekpu	gallon	pek	peck	
dembi	bean	bin	bean	
denci	tooth	dent	dent-	
denmi	dense	dens	dense	
denpa	wait	paz	pause	
dertu	dirt	drt	dirt	
dertu	dirt	rt	earth	
derxi	heap	xip	heap	
desku	shake	ceik	shake	
detri	date	deit	date	
dicra	interrupt	distrb	disturb	
dikca	electric	carj	charge	
diklo	local	lokl	local	
dikni	regular	siklik	cyclic	
dilcu	quotient	divijn	division	
dilnu	cloud	klaud	cloud	
dimna	fate	dum	doom	
dinju	building	bildin	building	
dinko	nail	neil	nail	
donri	daytime	deilait	daylight	
donri	daytime	deitaim	daytime	
draci	drama	drama	drama	
drani	correct	rait	right	
drata	other	atr	other	
drudi	roof	ruf	roof	
dugri	logarithm	lagaritm	logarithm	
dukse	excess	ekses	excess	
dukti	opposite	kantreri	contrary	
dunda	give	doneit	donate	
dunja	freeze	friz	freeze	
dunku	anguish	anguic	anguish	
dunli	equal	ikual	equal	
dunra	winter	uintr	winter	
dzena	ancestor	grandpernt	grandparent	
facki	discover	faind	find	
fadni	ordinary	kamn	common	
fagri	fire	fair	fire	
falnu	sail	seil	sail	
famti	aunt	ant	aunt	
fancu	function	fankcn	function	
fange	alien	farin	foreign	
fanmo	end	fainl	final	
fanri	factory	faktri	factory	
fanta	prevent	pravent	prevent	
fanva	translate	tranzleit	translate	
fanza	annoy	anoi	annoy	
fapro	oppose	apoz	oppose	
farlu	fall	fal	fall	
farna	direction	darekcn	direction	
farvi	develop	evalv	evolve	
fasnu	event	xapn	happen	
fatci	fact	fakt	fact	
fatne	reverse	rivrs	reverse	
fatri	distribute	distribiut	distribute	
febvi	boil	boil	boil	
fendi	divide	davaid	divide	
fendi	divide	particn	partition	
fengu	angry	angri	angry	
fenki	crazy	frenzi	frenzy	
fenra	crack	krak	crack	
fenso	sew	so	sew	
fepni	cent	peni	penny	
fepri	lung	palmneri	pulmonary	
ferti	fertile	frtl	fertile	
festi	waste	ueist	waste	
fetsi	female	fem	fem-	
figre	fig	fig	fig	
finpe	fish	fic	fish	
finti	invent	invent	invent	
flalu	law	la	law	
flani	flute	faif	fife	
flecu	flow	flo	flow	
fliba	fail	feil	fail	
flira	face	feis	face	
foldi	field	fild	field	
fonmo	foam	fom	foam	
fonxa	telephone	fon	phone	
forca	fork	fork	fork	
frati	react	riakt	react	
fraxu	forgive	frgiv	forgive	
frica	differ	difr	differ	
frili	easy	izi	easy	
frinu	fraction	frakcn	fraction	
friti	offer	ofr	offer	
frumu	frown	fraun	frown	
fukpi	copy	kapi	copy	
fulta	float	flot	float	
funca	luck	fortiun	fortune	
fusra	rotten	rat	rot	
fuzme	responsible	rispansabl	responsible	
gacri	cover	kavr	cover	
gadri	article	artikl	article	
galfi	modify	altr	alter	
galtu	high	xai	high	
galxe	throat	galat	gullet	
ganlo	closed	kloz	close	
ganra	broad	brad	broad	
ganse	sense	sens	sense	
ganti	testicle	testis	testes	
ganxo	anus	asxol	arsehole	
ganzu	organize	organaiz	organize	
gapci	gas	gas	gas	
gapru	above	ap	up	
garna	rail	bar	bar	
gasnu	do	du	do	
gasta	steel	stil	steel	
genja	root	rut	root	
genxu	hook	xuk	hook	
gerku	dog	dag	dog	
gerku	dog	keinain	canine	
gerna	grammar	gramr	grammar	
gidva	guide	gaid	guide	
ginka	camp	kamp	camp	
girzu	group	grup	group	
gismu	primitive	beis	base	
glare	hot	uarm	warm	
gleki	happy	gei	gay	
gletu	copulate	kapiuleit	copulate	
gluta	glove	glav	glove	
gradu	unit	dagri	degree	
grake	gram	gram	gram	
grana	rod	rad	rod	
grasu	grease	gris	grease	
greku	frame	freim	frame	
grusi	gray	grei	gray	
grute	fruit	frut	fruit	
gubni	public	pablik	public	
gugde	country	kantri	country	
gundi	industry	indastri	industry	
gunka	work	urk	work	
gunma	jointly	mas	mass	
gunro	roll	rol	roll	
gunse	goose	gus	goose	
gunta	attack	atak	attack	
gurni	grain	grein	grain	
guska	scrape	skreip	scrape	
gusni	illumine	lait	light	
gusta	restaurant	restarnt	restaurant	
gutci	cubit	fut	foot	
gutra	womb	iutras	uterus	
guzme	melon	meln	melon	
jabre	brake	breik	brake	
jadni	adorn	adorn	adorn	
jakne	rocket	rakit	rocket	
jalge	result	rizalt	result	
jalna	starch	starc	starch	
jalra	cockroach	kakroc	cockroach	
jamfu	foot	fut	foot	
jamna	war	uor	war	
janbe	bell	bel	bell	
janco	shoulder	coldr	shoulder	
janli	collide	kalaid	collide	
jansu	diplomat	kansl	consul	
janta	account	akaunt	account	
jarbu	suburb	sabrb	suburb	
jarco	show	co	show	
jarki	narrow	naro	narrow	
jaspu	passport	pasport	passport	
jatna	captain	kaptn	captain	
javni	rule	rul	rule	
jbama	bomb	bam	bomb	
jbari	berry	beri	berry	
jbena	born	ber	bear	
jbera	borrow	baro	borrow	
jbini	between	bituin	between	
jdari	firm	xard	hard	
jdice	decide	disaid	decide	
jdika	decrease	dikris	decrease	
jdima	price	prais	price	
jdini	money	mani	money	
jduli	jelly	jeli	jelly	
jecta	polity	steit	state	
jeftu	week	uik	week	
jelca	burn	brn	burn	
jemna	gem	jem	gem	
jenca	shock	cak	shock	
jendu	axle	spindl	spindle	
jenmi	army	armi	army	
jerna	earn	rn	earn	
jersi	chase	ceis	chase	
jersi	chase	prsu	pursue	
jesni	needle	nidl	needle	
jetce	jet	jet	jet	
jetnu	true	tru	true	
jgalu	claw	taln	talon	
jganu	angle	angl	angle	
jgari	grasp	grip	grip	
jgena	knot	nat	knot	
jgina	gene	jin	gene	
jgira	pride	praid	pride	
jgita	guitar	gitar	guitar	
jibni	near	nir	near	
jibri	job	job	job	
jicla	stir	str	stir	
jicmu	basis	faundeicn	foundation	
jijnu	intuit	intuit	intuit	
jikca	socialize	socal	social	
jikru	liquor	likr	liquor	
jilka	alkali	alkalai	alkali	
jilra	jealous	jelas	jealous	
jimca	branch	lim	limb	
jimpe	understand	kampraxend	comprehend	
jimte	limit	limit	limit	
jinci	shears	cirz	shears	
jinga	win	uin	win	
jinku	vaccine	inakiuleicn	inoculation	
jinme	metal	metl	metal	
jinru	immerse	imrs	immerse	
jinsa	clean	klin	clean	
jinto	well	sprin	spring	
jinvi	opine	apinian	opinion	
jinzi	innate	ineit	innate	
jipci	chicken	cikn	chicken	
jipno	tip	tip	tip	
jirna	horn	xorn	horn	
jisra	juice	jus	juice	
jitfa	false	fals	false	
jitro	control	kantrol	control	
jivbu	weave	uiv	weave	
jivna	compete	raivl	rival	
jmaji	gather	gadr	gather	
jmaji	gather	kalekt	collect	
jmifa	shoal	rif	reef	
jmina	add	agment	augment	
jmive	live	live	live	
jorne	joined	join	join	
jubme	table	tebl	table	
jubme	table	teibl	table	
judri	address	adres	address	
jufra	sentence	sentns	sentence	
jufra	sentence	steitmnt	statement	
jukni	spider	araknid	arachnid	
jukpa	cook	kuk	cook	
julne	net	net	net	
jundi	attentive	atend	attend	
junla	clock	klak	clock	
junri	serious	sirias	serious	
junta	weight	ueit	weight	
jurme	germ	jrm	germ	
jursa	severe	savir	severe	
jutsi	species	spisiz	species	
juxre	clumsy	akuard	awkward	
jvinu	view	viu	view	
kabri	cup	kap	cup	
kacma	camera	kamra	camera	
kafke	cough	kaf	cough	
kagni	company	kampani	company	
kajde	warn	kacn	caution	
kajna	shelf	kauntr	counter	
kakne	able	kan	can	
kakpa	dig	dig	dig	
kalci	feces	cit	shit	
kalri	open	opn	open	
kalsa	chaotic	keias	chaos	
kalte	hunt	xant	hunt	
kamju	column	kalam	column	
kamni	committee	kamicn	commission	
kamni	committee	kamiti	committee	
kampu	common	kamn	common	
kanba	goat	got	goat	
kancu	count	kaunt	count	
kandi	dim	dim	dim	
kanji	calculate	rekan	reckon	
kanla	eye	okial	ocular	FIXIT correct transcription ``okiul''
kanro	healthy	xelti	healthy	
kansa	with	kampani	company	
kantu	quantum	kuant	quant[um]	
kanxe	conjunction	and	and	
karbi	compare	kamper	compare	
karce	car	kar	car	
karda	card	kard	card	
kargu	costly	kastli	costly	
karli	collar	kalr	collar	
karni	journal	jrnl	journal	
katna	cut	kat	cut	
kavbu	capture	kac	catch	
kecti	pity	piti	pity	
kelci	play	plei	play	
kenra	cancer	kansr	cancer	
kensa	outer	speis	space	
kerfa	hair	xer	hair	
kerlo	ear	orl	aural	
kevna	cavity	keiv	cave	
kicne	cushion	kucn	cushion	
kijno	oxygen	aksijn	oxygen	
kinli	sharp	kin	keen	
klaji	street	avaniu	avenue	
klaku	weep	krai	cry	
klama	come	kam	come	
klani	quantity	kuantati	quantity	
klesi	class	klas	class	
klina	clear	klir	clear	
kliru	chlorine	klorin	chlorine	
kliti	clay	klei	clay	
klupe	screw	skru	screw	
kluza	loose	blauzd	bloused	
kobli	cabbage	kol	cole-	
kojna	corner	kornr	corner	
kolme	coal	kol	coal	
komcu	comb	kom	comb	
konju	cone	kon	cone	
korbi	edge	bordr	border	
korcu	bent	kruked	crooked	
korka	cork	kork	cork	
kosta	coat	kot	coat	
kramu	acre	eikr	acre	
krasi	source	arajin	origin	
krasi	source	kamens	commence	
krasi	source	orajin	origin	
krati	represent	praksi	proxy	
krefu	recur	rikr	recur	
krici	believe	krid	creed	
krili	crystal	kristl	crystal	
krinu	reason	rizn	reason	
krixa	cry	krai	cry	
kruca	intersect	kras	cross	
kruji	cream	krim	cream	
kruvi	curve	krv	curve	
kubli	cube	kiub	cube	
kucli	curious	kiurias	curious	
kufra	comfort	kamfrt	comfort	
kukte	delicious	teisti	tasty	
kulnu	culture	kalcr	culture	
kumfa	room	rum	room	
kumte	camel	kaml	camel	
kunra	mineral	minrl	mineral	
kunti	empty	vaiknt	vacant	
kurfa	square	skuar	square	
kurji	take	ker	care	
kurki	bitter	akrid	bitter	
kuspe	range	span	span	
kusru	cruel	krul	cruel	
labno	wolf	lupain	lupine	
lacpu	pull	pul	pull	
lacri	rely	rilai	rely	
ladru	milk	laktik	lactic	
lafti	lift	lift	lift	
lakne	probable	laikli	likely	
lakse	wax	uaks	wax	
lalxu	lake	lagun	lagoon	
lamji	adjacent	ajeisnt	adjacent	
lanbi	protein	albiumin	albumin	
lanci	flag	banr	banner	
lanka	basket	baskit	basket	
lanli	analyze	analaiz	analyze	
lanme	sheep	lam	lamb	
lante	can	kan	can	
lanxe	balance	balans	balance	
lanzu	family	klan	clan	
larcu	art	art	art	
lasna	fasten	fasn	fasten	
lastu	brass	bras	brass	
latna	lotus	lotas	lotus	
lazni	lazy	leizi	lazy	
lebna	take	teik	take	
lenjo	lens	lenz	lens	
lenku	cold	kul	cool	
lerci	late	leit	late	
lerfu	letteral	letr	letter	
lidne	leader	lidr	leader	
lifri	experience	ikspirins	experience	
lijda	religion	rilij	religion	
limna	swim	suim	swim	
lindi	lightning	laitnin	lightning	
linji	line	linir	linear	
linsi	chain	cein	chain	
linto	lightweight	lait	light	
lisri	story	stori	story	
liste	list	list	list	
litce	liter	litr	liter	
litki	liquid	likuid	liquid	
litru	travel	travl	travel	
livga	liver	livr	liver	
livla	fuel	fiul	fuel	
logji	logic	lajik	logic	
loldi	floor	flor	floor	
lorxu	fox	faks	fox	
lumci	wash	uac	wash	
lunbe	bare	ber	bare	
lunra	lunar	lunr	lunar	
lunsa	condense	kndens	condense	
mabla	derogative	mal	mal-	
mabru	mammal	maml	mammal	
macnu	manual	maniul	manual	
makcu	mature	matiur	mature	
makfa	magic	majik	magic	
maksi	magnet	magnit	magnet	
malsi	temple	templ	temple	
mamta	mother	ma	ma	
mamta	mother	mam	mum	
manci	wonder	uandr	wonder	
manfo	uniform	iunaform	uniform	
manku	dark	dark	dark	
manri	reference	standrd	standard	
mansa	satisfy	satisfai	satisfy	
manti	ant	ant	ant	
mapku	cap	kap	cap	
mapni	cotton	katn	cotton	
mapti	fit	mac	match	
marbi	shelter	xarbr	harbor	
marce	vehicle	viakl	vehicle	
marce	vehicle	vixikl	vehicle	
marde	morals	marlz	morals	
margu	mercury	mrkiuri	mercury	
marji	material	matr	matter	
marna	hemp	merauana	marijuana	
marxa	mash	mac	mash	
masno	slow	slo	slow	
masti	month	mant	month	
matci	mat	mat	mat	
matli	linen	linen	linen	
matne	butter	batr	butter	
matra	motor	motr	motor	
mavji	oats	ots	oats	
maxri	wheat	xuit	wheat	
mebri	brow	brau	brow	
melbi	beautiful	biutafl	beautiful	
menli	mind	mentl	mental	
mensi	sister	sistr	sister	
mentu	minute	minat	minute	
merli	measure	mejr	measure	
midju	middle	midl	middle	
mifra	code	saifr	cipher	
mikce	doctor	medik	medic	
milxe	mild	maild	mild	
minde	command	kamand	command	
minji	machine	macin	machine	
minli	mile	mail	mile	
minra	reflect	mirr	mirr[or]	
mintu	same	aident	ident-	
mipri	secret	sikrit	secret	
mirli	deer	dir	deer	
misno	famous	feimas	famous	
mitre	meter	mitr	meter	
mixre	mixture	mikscr	mixture	
mlana	side	latrl	lateral	
mlatu	cat	kat	cat	
mleca	less	les	less	
mledi	mold	mold	mold	
mluni	satellite	mun	moon	
mokca	point	momnt	moment	
moklu	mouth	orl	oral	
molki	mill	mil	mill	
morji	remember	rimembr	remember	
morna	pattern	patrn	pattern	
morsi	dead	mort	mort-	
mosra	friction	frikcn	friction	
mraji	rye	rai	rye	
mrilu	mail	mail	mail	
mruli	hammer	xamr	hammer	
mucti	immaterial	imatiril	immaterial	
mudri	wood	uud	wood	
mukti	purpose	motiv	motive	
mulno	complete	kamplit	complete	
munje	universe	iunavrs	universe	
mupli	example	igzampl	example	
murse	glimmering	glimer	glimmer	
murta	curtain	krtn	curtain	
mutce	much	muc	much	
muvdu	move	muv	move	
muzga	museum	miuziam	museum	
nabmi	problem	prablm	problem	
nakni	male	maskialin	masculine	
nalci	wing	uin	wing	
namcu	number	nambr	number	
nanba	bread	bred	bread	
nanca	year	aniu	annu[al]	
nandu	difficult	xard	hard	
nanla	boy	lad	lad	
nanmu	man	man	man	
narge	nut	nat	nut	
narju	orange	arinj	orange	
natfe	deny	dinai	deny	
natmi	nation	nacn	nation	
navni	neon	nian	neon	
naxle	canal	kanal	canal	
nazbi	nose	noz	nose	
nejni	energy	enrji	energy	
nelci	fond	laik	like	
nenri	in	inr	inner	
nibli	necessitate	enteil	entail	
nicte	night	nait	night	
nikle	nickel	nikl	nickel	
nilce	furniture	frnic	furnish	
nimre	citrus	sitr	citr[us]	
ninmu	woman	uimin	women	
nirna	nerve	niurl	neural	
nitcu	need	nid	need	
nivji	knit	nit	knit	
nixli	girl	girl	girl	
nobli	noble	nobl	noble	
notci	message	not	note	
nukni	magenta	fuksin	fuchsin	
nupre	promise	pramis	promise	
nurma	rural	rurl	rural	
nutli	neutral	nutrl	neutral	
nuzba	news	nuz	news	
pacna	hope	xop	hope	
pagbu	part	part	part	
pagre	pass	pas	pass	
pajni	judge	jaj	judge	
palci	evil	malign	malign	
palku	pants	pans	pants	
palne	tray	trei	tray	
palta	plate	pleit	plate	
pambe	pump	pamp	pump	
panci	odor	fragrans	fragrance	
pandi	punctuate	pankcuueit	punctuate	
panje	sponge	spanj	sponge	
panka	park	park	park	
panlo	slice	sleis	slice	
panpi	peace	pis	peace	
panra	parallel	paralel	parallel	
pante	protest	protest	protest	
panzi	offspring	prajeni	progeny	
papri	page	peij	page	
parbi	ratio	reit	rate	
pastu	robe	tunik	tunic	
patfu	father	pa	pa	
patlu	potato	pateit	potat[o]	
patxu	pot	pat	pot	
pelji	paper	peipr	paper	
pelxu	yellow	ielo	yellow	
pemci	poem	pom	poem	
penbi	pen	pen	pen	
pencu	touch	tac	touch	
pendo	friend	frend	friend	
penmi	meet	mit	meet	
pensi	think	pensiv	pensive	
perli	pear	per	pear	
pesxu	paste	peist	paste	
pezli	leaf	lif	leaf	
pijne	pin	pin	pin	
pikci	beg	saplikeit	supplicate	
pikta	ticket	tiket	ticket	
pilji	multiply	maltaplai	multiply	
pilka	crust	pil	peel	
pilno	use	emploi	employ	
pimlu	feather	plum	plume	
pinca	urine	pi	pee	
pindi	poor	indijnt	indigent	
pinfu	prisoner	prizanr	prisoner	
pinji	penis	pinas	penis	
pinka	comment	kament	comment	
pinsi	pencil	pensl	pencil	
pinta	level	xarazantl	horizontal	
pinta	level	xorazantl	horizontal	
pinxe	drink	drink	drink	
pipno	piano	piano	piano	
pixra	picture	pikcr	picture	
plana	plump	plamp	plump	
platu	plan	plan	plan	
pleji	pay	pei	pay	
plibu	pubic	piub	pub[ic]	
plini	planet	planit	planet	
plipe	leap	lip	leap	
plise	apple	apl	apple	
plita	plane	plein	plane	
plixa	plow	plau	plow	
pluja	complicated	kamplakeit	complicate	
pluka	please	pliz	please	
pluta	route	rut	route	
polje	fold	fold	fold	
ponse	possess	on	own	
porpi	break	breik	break	
porsi	sequence	ordr	order	
prali	profit	prafit	profit	
prami	love	lav	love	
prane	perfect	prfikt	perfect	
preja	spread	spred	spread	
prenu	person	prsn	person	
preti	question	kueri	query	
prije	wise	seij	sage	
prina	print	print	print	
pritu	right	rait	right	
prosa	prose	proz	prose	
pruce	process	prases	process	
pruni	elastic	sprin	spring	
pruxi	spirit	spirit	spirit	
pulce	dust	dast	dust	
pulji	police	palis	police	
pulni	pulley	puli	pulley	
punji	put	put	put	
punli	swelling	suel	swell	
purci	past	rlir	earlier	
purdi	garden	gardn	garden	
purmo	powder	paudr	powder	
racli	sane	racnl	rational	
ractu	rabbit	rabit	rabbit	
rafsi	affix	afiks	affix	
ragve	across	akras	across	
raktu	trouble	trabl	trouble	
ralci	delicate	frajl	fragile	
ralju	principal	prinsapal	principal	
ralte	retain	ritein	retain	
randa	yield	srendr	surrender	
rango	organ	orgn	organ	
ranji	continue	kntiniu	continue	
ranmi	myth	mit	myth	
ransu	bronze	branz	bronze	
ranti	soft	saft	soft	
ranxi	irony	airni	irony	
rapli	repeat	ripit	repeat	
rarna	natural	nacrl	natural	
ratcu	rat	rat	rat	
ratni	atom	atm	atom	
rebla	tail	teil	tail	
rectu	meat	flec	flesh	
remna	human	iumn	human	
renro	throw	tro	throw	
renvi	survive	srvaiv	survive	
respa	reptile	reptail	reptile	
ricfu	rich	ric	rich	
rigni	disgust	ripagnnt	repugnant	
rijno	silver	arjent	argent	
rilti	rhythm	ritm	rhythm	
rimni	rhyme	raim	rhyme	
rinci	drain	drein	drain	
rinju	restrain	ristrein	restrain	
rinka	cause	kaz	cause	
rinsa	greet	grit	greet	
rirci	rare	rer	rare	
rirni	parent	rir	rear	
rirxe	river	rivr	river	
rismi	rice	rais	rice	
risna	heart	kardiak	cardiac	
ritli	rite	rait	rite	
rivbi	avoid	iveid	avoid	
rokci	rock	rak	rock	
romge	chrome	krom	chrome	
rorci	procreate	prokrieit	procreate	
rotsu	thick	staut	stout	
rozgu	rose	roz	rose	
ruble	weak	fibl	feeble	
rufsu	rough	raf	rough	
runme	melt	melt	melt	
runta	dissolve	dizalv	dissolve	
rupnu	dollar	paund	pound	
rutni	artifact	artaficl	artificial	
sabji	provide	saplai	supply	
sabnu	cabin	kabn	cabin	
sacki	match	mac	match	
saclu	decimal	desaml	decimal	
sakci	suck	sak	suck	
sakli	slide	slip	slip	
sakta	sugar	sukros	sucrose	
salci	celebrate	selabreit	celebrate	
salpo	slope	slop	slope	
salta	salad	salad	salad	
samcu	cassava	iam	yam	
sampu	simple	simpl	simple	
sance	sound	saund	sound	
sanga	sing	sin	sing	
sanji	conscious	kancas	conscious	
sanli	stand	stand	stand	
sanmi	meal	mil	meal	
sanso	sauce	sas	sauce	
santa	umbrella	parasal	parasol	
sarcu	necessary	nesaseri	necessary	
sarji	support	saport	support	
sarlu	spiral	spairl	spiral	
sarxe	harmonious	xarmoni	harmony	
saske	science	sains	science	
satci	exact	prisais	precise	
satre	stroke	strok	stroke	
savru	noise	klamr	clamor	
sazri	operate	apreit	operate	
sefta	surface	srfis	surface	
selci	cell	sel	cell	
selfu	serve	srv	serve	
senci	sneeze	sniz	sneeze	
senpi	doubt	skeptik	sceptic	
senta	layer	stratm	stratum	
senva	dream	revari	reverie	
sepli	apart	separet	separate	
serti	stairs	sterz	stairs	
setca	insert	insrt	insert	
sevzi	self	self	self	
sfani	fly	flai	fly	
sfasa	punish	kastageit	castigate	
sfofa	sofa	sof	sofa	
sfubu	dive	suup	swoop	
siclu	whistle	uisl	whistle	
sicni	coin	spici	specie	
sidbo	idea	aidi	idea	
sidju	help	eid	aid	
sigja	cigar	sigar	cigar	
silka	silk	silk	silk	
silna	salt	salt	salt	
simlu	seem	sim	seem	
simsa	similar	simalr	similar	
simxu	mutual	miucul	mutual	
since	snake	sneik	snake	
sinma	esteem	astim	esteem	
sinxa	sign	sain	sign	
sipna	sleep	slip	sleep	
sirji	straight	streit	straight	
sisku	seek	sik	seek	
sisti	cease	sis	cease	
sitna	cite	sait	cite	
sivni	private	privi	privy	
skaci	skirt	skrt	skirt	
skami	computer	kampiutr	computer	
skapi	pelt	skin	skin	
skari	color	kalr	color	
skicu	describe	diskraib	describe	
skiji	ski	ski	ski	
skina	cinema	sinam	cinem[a]	
skori	cord	kord	cord	
skuro	groove	fro	furrow	
slabu	old	old	old	
slaka	syllable	silabl	syllable	
slami	acid	asid	acid	
slanu	cylinder	silndr	cylinder	
slari	sour	saur	sour	
slasi	plastic	plastik	plastic	
sligu	solid	salid	solid	
slilu	oscillate	asaleit	oscillate	
sliri	sulfur	salfr	sulfur	
sluji	muscle	masl	muscle	
sluni	onion	anian	onion	
smacu	mouse	maus	mouse	
smadi	guess	srmaiz	surmise	
smaji	quiet	sailnt	silent	
smani	monkey	manki	monkey	
smoka	sock	stokin	stocking	
smuci	spoon	spun	spoon	
smuni	meaning	minin	meaning	
snada	succeed	saksid	succeed	
snanu	south	saut	south	
snidu	second	seknd	second	
snime	snow	sno	snow	
snipa	sticky	stiki	sticky	
snuji	sandwich	sanuic	sandwich	
snura	secure	sikiur	secure	
snuti	accidental	aksadent	accident	
sobde	soya	soi	soy	
sodna	sodium	sodiam	sodium	
sodva	soda	soda	soda	
solji	gold	gold	gold	
solri	solar	solr	solar	
sombo	sow	so	sow	
sonci	soldier	soljr	soldier	
sorcu	store	stor	store	
sorgu	sorghum			FIXIT ``typo should have been sargu, loses all Chinese and Hindi''
sovda	egg	ovam	ovum	
spaji	surprise	srpraiz	surprise	
spali	polish	palic	polish	
spati	plant	plant	plant	
speni	married	spaus	spouse	
spisa	piece	pis	piece	
spita	hospital	xaspitl	hospital	
spofu	broken	brok	broken	
spofu	broken	brokn	broken	
spoja	explode	iksplod	explode	
spuda	reply	rispand	respond	
sputu	spit	spit	spit	
sraji	vertical	aprait	upright	
sraku	scratch	skrac	scratch	
srana	pertain	knsrn	concern	
srasu	grass	gras	grass	
srera	err	er	err	
sruma	assume	asum	assume	
sruri	surround	sraund	surround	
stace	honest	anast	honest	
stagi	vegetable	vejtabl	vegetable	
staku	ceramic	saramik	ceramic	
stali	remain	stei	stay	
stani	stalk	stak	stalk	
stapa	step	step	step	
stasu	soup	stu	stew	
stati	talent	talnt	talent	
steba	frustration	frastreicn	frustration	
steci	specific	specl	special	
stedu	head	xed	head	
stela	lock	lak	lock	
stici	west	uest	west	
stidi	suggest	sagjest	suggest	
stika	adjust	ajast	adjust	
stizu	chair	stul	stool	
stodi	constant	steibl	stable	
stuna	east	ist	east	
stura	structure	strakcr	structure	
stuzi	site	pazicn	position	
sucta	abstract	abstakt	abstract	
sucta	abstract	abstrakt	abstract	
sudga	dry	drai	dry	
sufti	hoof	xuf	hoof	
suksa	sudden	sadn	sudden	
sumji	sum	sam	sum	
sumne	smell	smel	smell	
sumti	argument	argiumnt	argument	
sunga	garlic	garlik	garlic	
sunla	wool	uul	wool	
surla	relax	rilaks	relax	
sutra	fast	suift	swift	
tabno	carbon	karbn	carbon	
tabra	trumpet	bras	brass	
tadji	method	metad	method	
tadni	study	stadi	study	
tagji	snug	tait	tight	
talsa	challenge	calnj	challenge	
tamca	tomato	tamato	tomato	
tamji	thumb	tam	thumb	
tamne	cousin	kazn	cousin	
tanbo	board	bord	board	
tance	tongue	tan	tongue	
tanko	tobacco	tabako	tobacco	
tanru	metaphor	metafor	metaphor	
tansi	pan	pan	pan	
tansi	pan	tab	tub	
tanxe	box	trank	trunk	
tapla	tile	tail	tile	
tarbi	embryo	fitas	fetus	
tarci	star	star	star	
tarla	tar	tar	tar	
tarmi	shape	form	form	
tarti	behave	kndakt	conduct	
taske	thirst	trst	thirst	
tatpi	tired	taird	tired	
tatru	breast	tit	tit	
tavla	talk	tak	talk	
taxfu	garment	garmnt	garment	
taxfu	garment	klodin	clothing	
taxfu	garment	kloz	clothes	
tcaci	custom	xabit	habit	
tcadu	city	taun	town	
tcana	station	steicn	station	
tcati	tea	ti	tea	
tcena	stretch	ikstend	extend	
tcica	deceive	trik	trick	
tcidu	read	rid	read	
tcika	time	taim	time	
tcila	detail	diteil	detail	
tcima	weather	mitiralaj	meterolog[y]	
tcini	situation	steit	state	
tcita	label	tag	tag	
temci	time	tempo	tempo	
tenfa	exponential	eksponencl	exponential	
tengu	texture	tekscr	texture	
terdi	earth	ter	terr[a]	
terpa	fear	terr	terr-	
tigni	perform	prform	perform	
tikpa	kick	kik	kick	
tilju	heavy	ueiti	weighty	
tinbe	obey	obei	obey	
tinci	tin	tin	tin	
tinsa	stiff	stif	stiff	
tirna	hear	xir	hear	
tirse	iron	airn	iron	
tirxu	tiger	taigr	tiger	
tisna	fill	staf	stuff	
titla	sweet	suit	sweet	
tivni	television	tivi	TV	
tixnu	daughter	datr	daughter	
toknu	oven	ovn	oven	
toldi	butterfly	batrflai	butterfly	
tonga	tone	ton	tone	
tordu	short	cort	short	
torni	twist	torcn	torsion	
traji	superlative	ekstrim	extreme	
trano	nitrogen	naitro	nitro-	
trati	taut	tat	taut	
trene	train	trein	train	
tricu	tree	tri	tree	
trina	attract	atrakt	attract	
trixe	behind	rir	rear	
troci	try	trai	try	
tsali	strong	stran	strong	
tsani	sky	skai	sky	
tsapi	seasoning	spais	spice	
tsiju	seed	sid	seed	
tsina	stage	steij	stage	
tubnu	tube	tub	tube	
tugni	agree	agri	agree	
tujli	tulip	tulip	tulip	
tumla	land	land	land	
tunba	sibling	siblin	sibling	
tunka	copper	kapr	copper	
tunlo	swallow	sualo	swallow	
tunta	poke	stab	stab	
tuple	leg	leg	leg	
turni	govern	gavrn	govern	
tutci	tool	tul	tool	
tutra	territory	teratori	territory	
vacri	air	er	air	
vajni	important	signifik	significant	
valsi	word	urd	word	
vamji	value	valiu	value	
vamtu	vomit	vamit	vomit	
vanbi	environment	ambint	ambient	
vanci	evening	ivnin	evening	
vanju	wine	vain	wine	
vasru	contain	vesl	vessel	
vasxu	breathe	brid	breathe	
vecnu	sell	vend	vend	
venfu	revenge	avenj	avenge	
vensa	spring	vernl	vernal	
verba	child	caild	child	
vibna	vagina	vajaina	vagina	
vidni	video	vidio	video	
vidru	virus	vairus	virus	
vifne	fresh	frec	fresh	
vikmi	excrete	ekskrit	excrete	
viknu	viscous	tik	thick	
vimcu	remove	rimuv	remove	
vindu	poison	venm	venom	
vinji	airplane	erplein	airplane	
vipsi	deputy	vais	vice-	
virnu	brave	valient	valiant	
viska	see	viu	view	
viska	see	viz	vis-	
vitci	irregular	intrmitnt	intermittent	
vitke	guest	vizit	visit	
vitno	permanent	itrnl	eternal	
vlagi	vulva	vulva	vulva	
vlile	violent	vaialnt	violent	
vlina	alternation	altrneicn	alternation	
vlipa	powerful	paur	power	
vofli	flight	flai	fly	
voksa	voice	vois	voice	
voksa	voice	vokal	vocal	
vorme	door	dor	door	
vraga	lever	levr	lever	
vraga	lever	livr	lever	
vreji	record	rekrd	record	
vreta	reclining	rest	rest	
vrici	miscellaneous	varias	various	
vrude	virtue	vrtiu	virtue	
vrusi	taste	flavr	flavor	
xabju	dwell	inxabit	inhabit	
xadba	half	xaf	half	
xadni	body	badi	body	
xagji	hunger	xangr	hunger	
xagri	reed	rid	reed	
xajmi	funny	kamik	comic	
xaksu	use	knsum	consume	
xalbo	levity	frivalas	frivolous	
xalka	alcohol	alkaxal	alcohol	
xalni	panic	panik	panic	
xamgu	good	gud	good	
xamsi	sea	si	sea	
xance	hand	xand	hand	
xanka	nervous	ankcas	anxious	
xanri	imaginary	anril	unreal	
xanto	elephant	elafnt	elephant	
xarci	weapon	arm	arm	
xarju	pig	xag	hog	
xarnu	stubborn	stabrn	stubborn	
xasli	donkey	as	ass	
xasne	sweat	suet	sweat	
xatra	letter	letr	letter	
xebni	hate	xeit	hate	
xedja	jaw	ja	jaw	
xekri	black	blak	black	
xendo	kind	kaind	kind	
xenru	regret	ru	rue	
xinmo	ink	ink	ink	
xirma	horse	xors	horse	
xislu	wheel	xuil	wheel	
xlali	bad	mal	mal-	
xlura	influence	influans	influence	
xotli	hotel	xotel	hotel	
xrani	injure	xrt	hurt	
xruba	buckwheat	rubarb	rubarb	
xruki	turkey	trki	turkey	
xrula	flower	blasm	blossom	
xrula	flower	flaur	flower	
xruti	return	ritrn	return	
xukmi	chemical	kemikl	chemical	
xunre	red	red	red	
xusra	assert	asrt	assert	
xutla	smooth	smut	smooth	
zabna	favorable	bena	bene-	
zajba	gymnast	akrabat	acrobat	
zalvi	grind	palvraiz	pulverize	
zanru	approve	apruv	approve	
zarci	market	bazar	bazaar	
zargu	buttock	arse	arse	
zargu	buttock	rear	rear	
zasni	temporary	tranzint	transient	
zasti	exist	igzist	exist	
zbabu	soap	sop	soap	
zbani	bay	bei	bay	
zbasu	make	meik	make	
zbepi	pedestal	beis	base	
zdani	nest	den	den	
zdile	amusing	amiuzd	amused	
zekri	crime	kraim	crime	
zenba	increase	agment	augment	
zgana	observe	abzerv	observe	
zgike	music	miuzik	music	
zifre	free	fri	free	
zinki	zinc	zink	zinc	
zirpu	purple	prpl	purple	
zivle	invest	invest	invest	
zmadu	more	mor	more	
zmiku	automatic	atamatik	automatic	
zukte	act	akt	act	
zumri	maize	meiz	maize	
zungi	guilt	gilt	guilt	
zunle	left	left	left	
zunti	interfere	intrfir	interfere	
zutse	sit	sit	sit	
zvati	at	at	at	
